60x40
VOID:v
GRASS:g
TREE:t
ROCK:r
WATER:w
SPAWN:s

t t t t t t t t t t t t t t t t t t t t t t t t t t t t t t t t t t t t t t t t t t t t t t t t t t t t t t t t t t t t 
t s g g g g g t t g g g g g g g g g g g g g g t g g g g g g g g g g g g g g g g g g g g g g g g g g g g g g t g g g s t 
t t t t t t g t t g t t t t t t t t t t t t g t g t t t t t t t t t t t t t t t t t t t t t t t t g t t t t t g t t g t 
t t g t g t g t g g g t g g g g g g g g t t g t g t g g g g g g g g g g g g g g g g g g g g g g t g t g g g g g t t g t 
t t g t g t g t t t g t g t t t t t t t t t g t g t t t t t t t t t t t t t g t t g t t t t t g t g t g t t t t t t g t 
t g g g g t g g g g g t g t t t t t t t t t g t g g g g g g g g g g g g t t g t t g t g g g t g t g t g t t t t g t g t 
t g t t g t g t t t t t g g g g g g g g g g g t t t t t t t t t t t t g t t t t t g t g t g t g t g t g t t g g g t g t 
t g t t g t t t t g t t g t t t t t t t t t t t t t t g g g g g g g g g g g g g g g t g t g t g t g t g t t g t g t g t 
t g t t t t t t t g t t g t g g g g g g g g g g g g t t t t t t t t t t t t t t t t t t t g t g t g t g t t g t g t g t 
t g t t g g g g g g g t g t g t t t g t t t t t t g t g g g g g g g g g g g g t g g g g g g t g t g t g t t g t g t g t 
t g t t g t t t t t g t g t g g g t g t g g g g t g t g t t t t t t t t t t g t g t t t t t t g t g t g t t t t g t g t 
t g g g g t g g g t g t g t t g t t g t t t t g t g t g t t t t t t t t t t g t g t t t t t t g t g g g g g g t g t g t 
t g t t t t t t g t g t g t t g t t g t t t t g t g t g t g g g g g g g g t g t g g g g g g g g t t t t t t g t g t g t 
t g g g g g g g g t g t g t t t t t g t g g g g t g t g t g t t t g t t g t g t t t t t t t t t t t t t t t g t g t g t 
t t t t g t t t t t g t g g g g g g g t g t t t t g t g t g t t t g t t g t g g g g g g g g g g g t t g g g g t g t g t 
t g t t g t t t t t g t t t t t t t t t g t t t t g t g t g g g t g t t g t t t t t t t t t t t g t t t t t g g g t g t 
t g t t g t g g g g g g g g g t g g g g g g g g g g t g t t t t t g t t g t g t g g g g g g g t g t t t t t t t t t g t 
t g t t g t g t t t t t t g t t g t t t t t t t t t t g g g g g t g t t t t g t g t t t t t g t g t g g g g g g g g g t 
t g t t g t g t g g g g t g t t g t g g g g g g g g t g t t t g t g t t g g g g g g g t g t g t g t g t t t t t t t g t 
t g g g g t g t g t t t t g t t g t g t t t g t t g t g t g t g t g t t g t t t t t g t g t g t g t g t t t t t t t g t 
t t t t t t g t g g g g g g t t g t g g g t g t t g t g t g t g t g g g g g g g g t g t g g g t g t g t g g g g g g g t 
t t t t t t g t t t t t t t t t g t t t g t g t t g t g t g t g t t t t t t t t t t g t t t t t g t g t t t t t t t t t 
t g g g g g g t t t t t t t t t g t g t g t g t t t t g t g t g t t g g g g g g g t g t g g g g g t g t g g g g g g g t 
t g t t t t g t g g g g g g g g g t g t g t g g g g g g g g t g t t g t t t t t g t g t g t t t t t g t g t t t t t g t 
t g t t g t g t g t t t t t t t t t g g g t t t t g t t t t t g t t g t g g g t g t g t g t g g g g g t g t t t t t g t 
t g t t g t g t g t g t t t t t t t t t t t t t t g t t g t t g t t g t g t t t g t g t g t g t t t g t g t g g g t g t 
t g t t g t g t g t g g g g g g g g g g g g g g t g t t g t t g t t g t g g g g g g g t g t g t g g g t g t t t g t g t 
t g t t g t g t g t g t t t t t t t t t t t t g t g t t g t t g t t g t t t t t t t t t g t g t t t t t g t t t g t g t 
t g t t g t g t g t g t g g g g g g g g g g t g t g g g g g t g t t g t t g g g g g g g g t g g g g g g g g g g g t g t 
t g t t g t g t g t g t t t t t t t t t t g t g t t t t t t t g t t g t t g t t t t t t t t t t t t t t t t t t t t g t 
t g t t g t g t g t g t t g g g g g g g g g t g g g g g g g t g t t g t t g t g t t g g g g g g g g g g g g g g g g g t 
t g t t g t g t g t g t t g t t t t t t t g t t t t t t t g t g t t g t t g t g t t g t t t t t t t t t t t t t t t g t 
t g t t g t g t g t g t t g t g g g g g g g g g g g g g t g t g t t g t t g t g g g g t t t t t t t t t t t t t g t g t 
t g t t g t g t g t g t t g t g t t t t t t t t t t t t t g t g t t g t t g t t t t g t g g g g g g g g g g g t g t g t 
t g t t g t g t g t g t t g t g g g g g t g g g g g g g g g t g t t g t t g t t t t g t g t t t t t g t t t g t g t g t 
t g t t g g g t g t g t t g t t t t t t t g t t t t t t t t t g t t g t t g g g g g g t g t t t t t g t g g g g g t g t 
t g t t t t t t g t g t t g g g g g g g g g t t t t t t t t t g t t g t t t t t t t t t g g g g g t g t t t t t t t g t 
t g t t t t t t g g g t t g t t t t t t t g g g g g g g g g g g t t g t t t t t t t t t t t t t g t g g g g g g g g g t 
t s g g g g g g g t t t t g g g g g g g t t t t t t t t t t t t t t g g g g g g g g g g g g g g g t t t t t t t t t s t 
t t t t t t t t t t t t t t t t t t t t t t t t t t t t t t t t t t t t t t t t t t t t t t t t t t t t t t t t t t t t 

com.github.TheDwoon.robots.game.items.Star 22 15
com.github.TheDwoon.robots.game.items.Star 4 4
com.github.TheDwoon.robots.game.items.Star 41 25
com.github.TheDwoon.robots.game.items.Star 5 24
com.github.TheDwoon.robots.game.items.Star 40 5