15x10
VOID:v
GRASS:g
WATER:w

g g g g g g g g g g g v v v v
g g g g g g g g g g g g v v v
g g g g g g g g g g g g g v v
g g g g w w w w g g g g g g v
g g g w w w w w w g g g g g g
g g g g w w w w w g g g g g g
g g g g g w w w w g g g g g g
g g g g g g w w g g g g g g g
g g g g g g g g g g g g g g v
g g g g g g g g g g g g g v v